Name,A,B,C,D,F,totalGrades,qualitygroup,difficultygroup,dep_group
AP Pierce,369,75,22,6,25,497,4-5,2-3,HSSA
Aaron Blackwell,281,259,84,16,12,652,3-4,3-4,HSSA
Aaron Ettenberg,553,828,996,257,132,2766,4-5,3-4,HSSA
Aaron Sokoll,54,89,22,0,5,170,4-5,2-3,HSSA
Aaron Ullrey,57,111,24,4,9,205,3-4,3-4,HSSA
Aaron Zimmerman,1342,2444,741,60,196,4783,4-5,2-3,HSSA
Aashish Mehta,1175,941,571,166,75,2928,4-5,3-4,HSSA
Abdullah Salehuddin,86,25,20,2,8,141,4-5,2-3,HSSA
Adam Sabra,456,386,73,17,61,993,3-4,3-4,HSSA
Adriane Friedl,9,10,0,0,0,19,3-4,3-4,HSSA
Adrienne Edgar,956,991,235,18,65,2265,3-4,2-3,HSSA
Adrienne Tsikewa,86,87,30,14,14,231,1-2,3-4,HSSA
Ahmad Ahmad,482,489,102,22,44,1139,2-3,3-4,HSSA
Aida Hurtado,746,343,45,5,12,1151,3-4,1-2,HSSA
Akiyo Cantrell,783,368,104,18,10,1283,3-4,2-3,HSSA
Alan Fridlund,4028,9360,6158,2424,1495,23465,4-5,3-4,HSSA
Alan Liu,581,468,135,20,82,1286,2-3,4-5,HSSA
Albert Lindemann,83,79,37,4,9,212,3-4,4-5,HSSA
Albert Shin,106,179,43,8,4,340,4-5,2-3,HSSA
Aldo Cimino,400,580,268,108,60,1416,4-5,2-3,HSSA
Alenda Chang,433,487,143,24,16,1103,2-3,4-5,HSSA
Alex George,99,102,14,2,3,220,3-4,3-4,HSSA
Alex LeBrun,432,344,45,4,27,852,4-5,3-4,HSSA
Alex Simms,201,18,0,0,1,220,4-5,2-3,HSSA
Alexander Cho,968,196,33,8,23,1228,4-5,1-2,HSSA
Alexander Swan,146,375,253,46,24,844,2-3,3-4,HSSA
Alice O'Connor,1035,925,200,17,74,2251,3-4,3-4,HSSA
Alicia Boswell,445,145,42,6,15,653,2-3,3-4,HSSA
Alicia Cast,1803,1169,379,106,115,3572,4-5,2-3,HSSA
Alison Brysk,1463,800,170,20,32,2485,3-4,2-3,HSSA
Alison Butler,145,8,0,0,0,153,3-4,4-5,HSSA
Alison Williams,637,78,19,2,16,752,3-4,3-4,HSSA
Alli Johnson,304,126,13,1,7,451,4-5,2-3,HSSA
Allison Anders,788,51,7,1,9,856,4-5,1-2,HSSA
Allison Slade,2304,1521,403,75,136,4439,3-4,3-4,HSSA
Amanda Stansell,1280,988,52,1,30,2351,4-5,2-3,HSSA
Ambi Harsha,292,47,6,7,6,358,4-5,1-2,HSSA
Amedee Martella,180,28,10,2,0,220,4-5,1-2,HSSA
Ami Cohen,9,23,20,14,18,84,2-3,3-4,HSSA
Amit Ahuja,463,774,148,17,24,1426,4-5,3-4,HSSA
Amit Shilo,2292,1421,374,77,187,4351,3-4,2-3,HSSA
Amy Boddy,785,270,82,22,29,1188,4-5,2-3,HSSA
Amy Gonzales,754,1104,275,44,53,2230,2-3,3-4,HSSA
Amy Jamieson,7098,3503,1126,288,394,12409,3-4,2-3,HSSA
Amy Kyratzis,649,66,15,3,4,737,3-4,1-2,HSSA
Amy Lashmet,535,209,25,6,16,791,3-4,3-4,HSSA
Amy Martinez,280,53,8,6,11,358,3-4,2-3,HSSA
Amy Propen,949,171,18,1,9,1148,4-5,1-2,HSSA
Amy Small,379,124,5,4,0,512,3-4,3-4,HSSA
Ana Requena,107,190,109,27,16,449,4-5,1-2,HSSA
Andrea Fishman,325,122,30,1,19,497,2-3,3-4,HSSA
Andrea Nicolaescu,565,193,31,9,22,820,3-4,3-4,HSSA
Andrew Baker,547,182,37,7,15,788,4-5,2-3,HSSA
Andrew Flanagin,667,1201,943,187,110,3108,3-4,4-5,HSSA
Andrew Griffin,2042,1088,191,24,66,3411,4-5,2-3,HSSA
Andrew Jayich,9,0,1,0,1,11,1-2,3-4,HSSA
Andrew Norris,399,1034,647,156,146,2382,3-4,4-5,HSSA
Andy Merolla,1626,1302,406,94,110,3538,4-5,2-3,HSSA
Angela Ellis,128,57,15,1,4,205,4-5,2-3,HSSA
Ania Jayich,9,0,1,0,1,11,2-3,4-5,HSSA
Anita Stahl,541,111,30,7,29,718,4-5,2-3,HSSA
Ann Adams,561,360,113,19,22,1075,3-4,3-4,HSSA
Ann Bermingham,65,82,31,4,11,193,4-5,2-3,HSSA
Ann Holms,657,33,7,0,0,697,4-5,1-2,HSSA
Ann Plane,402,749,283,18,46,1498,3-4,3-4,HSSA
Ann-Elise Lewallen,1196,670,214,35,70,2185,3-4,2-3,HSSA
Anna Brusutti,2512,3949,1153,136,342,8092,3-4,3-4,HSSA
Anna Everett,348,300,53,3,19,723,3-4,2-3,HSSA
Anna James,31,3,0,0,1,35,4-5,2-3,HSSA
Anna Pajak,595,33,6,0,7,641,4-5,1-2,HSSA
Anna Wald,388,139,43,6,34,610,4-5,2-3,HSSA
Anne Marcoline,14,20,9,0,0,43,3-4,3-4,HSSA
Anne Taves,415,255,66,15,33,784,2-3,3-4,HSSA
Annie Yih,516,451,211,18,18,1214,3-4,2-3,HSSA
Anthony Anderson,43,34,28,4,3,112,2-3,3-4,HSSA
Antonio Cortijo,880,556,11,0,11,1458,3-4,2-3,HSSA
Art Gilbert,1096,1580,3279,178,193,6326,3-4,3-4,HSSA
Arthur Schwartz,30,31,24,21,5,111,2-3,3-4,HSSA
Audrey Lopez,635,72,19,6,23,755,4-5,1-2,HSSA
Auli Ek,1999,1370,97,8,30,3504,3-4,2-3,HSSA
Aurelie Chevant,15,8,1,0,1,25,4-5,1-2,HSSA
Austin Somers,56,76,13,0,1,146,4-5,2-3,HSSA
Avery Gordon,3600,1827,499,103,114,6143,3-4,2-3,HSSA
Barbara Holdrege,838,783,251,40,180,2092,3-4,3-4,HSSA
Barbara Thayer,146,327,185,53,42,753,3-4,4-5,HSSA
Barbara Tomlinson,240,171,23,3,12,449,4-5,4-5,HSSA
Barbara Vilander,46,55,12,0,2,115,4-5,2-3,HSSA
Baron Haber,315,200,37,2,17,571,4-5,2-3,HSSA
Baron Peters,359,394,218,53,39,1063,2-3,4-5,HSSA
Barry Giesbrecht,952,595,508,83,89,2227,4-5,3-4,HSSA
Ben Olguin,477,83,29,12,30,631,2-3,2-3,HSSA
Ben Reese,265,355,274,138,69,1101,2-3,4-5,HSSA
Benjamin Cohen,741,1206,250,14,32,2243,4-5,3-4,HSSA
Benjamin Zulueta,1653,1525,486,35,97,3796,3-4,3-4,HSSA
Bernadette Andrea,425,154,64,9,22,674,4-5,3-4,HSSA
Bernard Comrie,331,197,55,9,21,613,4-5,1-2,HSSA
Bhaskar Sarkar,614,773,204,30,69,1690,3-4,3-4,HSSA
Bianca Acevedo,169,127,55,3,3,357,1-2,3-4,HSSA
Billy Collins,43,14,8,3,3,71,4-5,2-3,HSSA
Bishnupriya Ghosh,1500,995,131,14,56,2696,3-4,2-3,HSSA
Bohan Zhou,23,1,0,0,0,24,3-4,3-4,HSSA
Brad Bouley,1416,552,134,29,78,2209,4-5,2-3,HSSA
Bradley Chmelka,578,664,229,16,27,1514,3-4,3-4,HSSA
Branden Adams,923,129,9,0,6,1067,3-4,2-3,HSSA
Brandon Fastman,20,7,4,3,0,34,4-5,2-3,HSSA
Brandon Seto,23,34,16,2,5,80,4-5,3-4,HSSA
Brenda Major,958,1169,610,200,100,3037,3-4,3-4,HSSA
Brent Strathman,1573,2448,993,180,208,5402,3-4,4-5,HSSA
Brett Collins,43,14,8,3,3,71,4-5,1-2,HSSA
Brett Land,88,51,3,0,0,142,4-5,2-3,HSSA
Brian Donnelly,3162,1924,413,47,149,5695,4-5,2-3,HSSA
Brian Ernst,970,240,22,0,18,1250,4-5,2-3,HSSA
Brian Lopez,103,196,252,64,26,641,4-5,2-3,HSSA
Briana Westmacott,990,247,29,6,8,1280,3-4,3-4,HSSA
Brice Erickson,3522,3099,1222,282,301,8426,4-5,2-3,HSSA
Bridget Coggins,643,945,290,49,96,2023,2-3,3-4,HSSA
Bridget O'Connell,905,302,59,9,26,1301,4-5,2-3,HSSA
Britt Andreatta,74,37,5,2,3,121,3-4,2-3,HSSA
Bruce Bimber,552,834,298,55,29,1768,4-5,3-4,HSSA
Burleigh Wilkins,90,175,22,0,9,296,2-3,2-3,HSSA
C McKoy,97,108,39,2,3,249,3-4,2-3,HSSA
Caitlin Taylor,1308,703,180,38,56,2285,3-4,2-3,HSSA
Caleb Miller,187,397,145,16,27,772,4-5,3-4,HSSA
Camilla Fiorina,1028,455,99,35,46,1663,4-5,2-3,HSSA
Candace Waid,1854,920,212,34,100,3120,3-4,3-4,HSSA
Caragh Barry,39,114,80,23,19,275,2-3,4-5,HSSA
Caren Converse,1381,722,29,2,8,2142,4-5,1-2,HSSA
Carl Harris,71,94,57,0,3,225,4-5,2-3,HSSA
Carla Borromeo,979,689,174,38,27,1907,4-5,2-3,HSSA
Carlos Morton,666,98,25,2,13,804,2-3,2-3,HSSA
Carlos Nash,316,156,25,4,6,507,4-5,1-2,HSSA
Carol Genetti,32,8,3,1,1,45,3-4,3-4,HSSA
Carol Lansing,1156,1413,316,28,86,2999,3-4,3-4,HSSA
Carol Press,9844,5677,2514,682,353,19070,3-4,1-2,HSSA
Carole Paul,1397,1742,521,71,180,3911,2-3,3-4,HSSA
Caroline Allen,77,114,69,11,24,295,4-5,2-3,HSSA
Casey Mongoven,293,31,11,1,0,336,4-5,1-2,HSSA
Casey Walsh,3750,4295,1039,159,165,9408,3-4,2-3,HSSA
Catherine Albanese,144,242,97,24,15,522,3-4,2-3,HSSA
Catherine Nesci,878,259,57,13,41,1248,4-5,2-3,HSSA
Catherine Taylor,1308,703,180,38,56,2285,3-4,3-4,HSSA
Cedric Robinson,256,434,72,0,20,782,3-4,3-4,HSSA
Celine Shimizu,195,236,22,1,8,462,3-4,3-4,HSSA
Charlene Garfinkle,1156,511,119,7,24,1817,4-5,2-3,HSSA
Charles Asche,478,34,1,0,4,517,4-5,4-5,HSSA
Charles Jones,570,82,29,5,17,703,3-4,2-3,HSSA
Charles Mullin,1502,1660,1053,324,136,4675,2-3,3-4,HSSA
Charles Wolfe,619,898,314,71,66,1968,4-5,3-4,HSSA
Charlotte Bremser,139,20,8,4,5,176,4-5,1-2,HSSA
Charmaine Chua,467,289,40,9,19,824,4-5,3-4,HSSA
Chela Sandoval,935,237,22,7,14,1215,2-3,3-4,HSSA
Chet Stussy,923,67,9,4,22,1025,4-5,1-2,HSSA
Chikako Shinagawa,1098,350,81,11,7,1547,4-5,2-3,HSSA
Chris McMahon,1409,1168,399,38,42,3056,3-4,2-3,HSSA
Chris Newfield,1302,984,135,19,48,2488,3-4,2-3,HSSA
Chris Still,0,0,0,0,5,5,3-4,2-3,HSSA
Christene D'Anca,393,46,12,1,14,466,4-5,2-3,HSSA
Christian Thomas,3540,1374,279,58,131,5382,4-5,3-4,HSSA
Christina McCarthy,1715,485,34,9,19,2262,3-4,3-4,HSSA
Christina McMahon,1409,1168,399,38,42,3056,4-5,2-3,HSSA
Christina Venegas,584,640,149,23,60,1456,2-3,3-4,HSSA
Christine Thomas,3540,1374,279,58,131,5382,4-5,2-3,HSSA
Christophe Corbin,126,99,21,1,3,250,3-4,3-4,HSSA
Christopher Cloos,335,375,136,37,30,913,3-4,3-4,HSSA
Christopher Cody Stephens,420,508,97,13,26,1064,2-3,3-4,HSSA
Christopher Dean,3008,1366,128,8,52,4562,4-5,1-2,HSSA
Christopher Kegerreis,334,447,187,24,42,1034,3-4,3-4,HSSA
Christopher McAuley,1905,1954,305,29,112,4305,4-5,2-3,HSSA
Christopher Ograin,464,234,40,3,5,746,4-5,2-3,HSSA
Christopher Parker,43,83,41,4,1,172,1-2,4-5,HSSA
Christopher Sprecher,555,577,55,7,15,1209,1-2,2-3,HSSA
Cissy Ross,432,117,19,3,2,573,4-5,1-2,HSSA
Claudia Moser,2097,1653,527,83,133,4493,3-4,2-3,HSSA
Claudio Campagnari,14,0,0,0,0,14,3-4,3-4,HSSA
Claudio Fogu,1565,1288,416,36,106,3411,3-4,3-4,HSSA
Clayton Nall,415,523,100,32,35,1105,3-4,3-4,HSSA
Clyde Woods,140,46,3,0,7,196,3-4,1-2,HSSA
Colin Gardner,458,43,18,6,19,544,4-5,2-3,HSSA
Constance Penley,1024,151,28,4,42,1249,3-4,2-3,HSSA
Corinna Reyes,406,564,153,18,13,1154,3-4,2-3,HSSA
Craig Cotich,697,1115,308,43,59,2222,4-5,2-3,HSSA
Craig Rawlings,1124,1140,452,91,68,2875,4-5,2-3,HSSA
Cynthia Brown,458,499,117,20,17,1111,3-4,3-4,HSSA
Cynthia Davis,167,437,134,13,20,771,4-5,2-3,HSSA
Cynthia Felando,559,1902,1314,177,175,4127,3-4,3-4,HSSA
Cynthia Kaplan,276,808,228,9,24,1345,2-3,4-5,HSSA
Cynthia Stohl,985,1126,229,2,20,2362,3-4,3-4,HSSA
Daigengna Duoer,144,43,6,1,11,205,4-5,2-3,HSSA
Dale Kretz,238,50,4,1,6,299,4-5,2-3,HSSA
Dan Lane,1258,623,131,32,36,2080,4-5,2-3,HSSA
Dan Montello,7,5,1,0,0,13,3-4,3-4,HSSA
Dan Pecchenino,80,248,25,1,10,364,4-5,2-3,HSSA
Dana Driskel,315,551,196,12,10,1084,4-5,3-4,HSSA
Dana Mastro,1088,687,109,10,2,1896,4-5,2-3,HSSA
Daniel Conroy-Beam,893,646,221,41,23,1824,4-5,3-4,HSSA
Daniel Frank,1002,175,22,5,31,1235,4-5,2-3,HSSA
Daniel Korman,978,1650,363,27,104,3122,4-5,3-4,HSSA
Daniel Masterson,247,172,20,10,11,460,2-3,2-3,HSSA
Daniel Reeve,481,292,43,2,39,857,3-4,3-4,HSSA
Daniel Story,357,475,207,63,44,1146,3-4,2-3,HSSA
Daniel Wuebben,734,169,30,1,7,941,4-5,1-2,HSSA
Danielle Hidalgo,126,215,60,6,21,428,3-4,4-5,HSSA
Danielle Kurin,680,177,57,11,12,937,4-5,3-4,HSSA
Danny Tsai,285,113,34,8,6,446,3-4,2-3,HSSA
Daoxiong Guan,1633,547,85,16,48,2329,4-5,1-2,HSSA
Darby Feldwinn,138,114,34,4,11,301,3-4,4-5,HSSA
Dasa Francikova,511,349,80,18,33,991,2-3,2-3,HSSA
David Cleveland,73,94,64,21,16,268,3-4,3-4,HSSA
David Fowler,242,132,40,8,10,432,4-5,3-4,HSSA
David Hamilton,120,131,134,24,27,436,3-4,4-5,HSSA
David Harris,289,74,5,0,6,374,2-3,2-3,HSSA
David King,163,245,72,11,13,504,2-3,3-4,HSSA
David Lawson,473,324,119,23,24,963,4-5,3-4,HSSA
David Lea,18,0,0,0,0,18,4-5,2-3,HSSA
David Malvinni,1470,281,58,18,26,1853,4-5,1-2,HSSA
David Moak,2402,1244,178,24,81,3929,4-5,2-3,HSSA
David Mokriski,734,763,216,46,72,1831,4-5,3-4,HSSA
David Novak,352,206,41,14,28,641,1-2,3-4,HSSA
David Paul,1182,654,175,33,53,2097,3-4,3-4,HSSA
David Rock,388,511,159,16,31,1105,3-4,2-3,HSSA
David Seibold,139,395,129,4,11,678,3-4,2-3,HSSA
David Sherman,1358,1828,1077,187,88,4538,3-4,3-4,HSSA
David Stuart,21,0,0,0,0,21,3-4,3-4,HSSA
David Walker,1024,521,119,25,55,1744,4-5,3-4,HSSA
David White,1909,1961,425,98,148,4541,3-4,3-4,HSSA
Dawn Holmes,93,37,1,0,0,131,3-4,2-3,HSSA
Dean Chen,543,637,131,13,29,1353,4-5,1-2,HSSA
Debanuj Dasgupta,749,83,23,8,16,879,3-4,2-3,HSSA
Deborah Fygenson,35,1,0,0,1,37,2-3,4-5,HSSA
Debra Lieberman,313,306,80,8,11,718,4-5,2-3,HSSA
Delila Moseley,2399,410,32,6,47,2894,3-4,1-2,HSSA
Denis Labutin,136,0,0,0,0,136,2-3,2-3,HSSA
Denise Bielby,825,409,102,32,38,1406,2-3,3-4,HSSA
Denise Segura,1234,829,227,47,115,2452,2-3,3-4,HSSA
Dennis Russell,566,231,39,10,18,864,3-4,1-2,HSSA
Derek Katz,2803,991,299,53,101,4247,4-5,2-3,HSSA
Diana Palenzuela,197,157,20,6,6,386,4-5,1-2,HSSA
Diane Fujino,693,1565,253,27,50,2588,3-4,3-4,HSSA
Diane MacKie,603,502,225,41,30,1401,3-4,3-4,HSSA
Didier Maleuvre,1779,1164,242,24,107,3316,3-4,3-4,HSSA
Dimitri Akulov,391,810,356,37,92,1686,4-5,2-3,HSSA
Dolly Mullin,4211,8523,5402,1270,855,20261,4-5,3-4,HSSA
Dolores Casillas,3181,1901,475,81,102,5740,4-5,2-3,HSSA
Dominique Jullien,618,744,202,33,43,1640,3-4,2-3,HSSA
Don Lubach,3818,820,139,37,58,4872,4-5,1-2,HSSA
Dorota Dutsch,702,621,312,68,77,1780,4-5,2-3,HSSA
Dorothy M. Chun,208,43,15,3,2,271,4-5,2-3,HSSA
Douglas Daniels,7,29,26,3,3,68,1-2,3-4,HSSA
Douglas Kennett,851,280,74,27,90,1322,3-4,2-3,HSSA
Dustin Lovett,403,169,39,10,28,649,3-4,3-4,HSSA
Dwight Reynolds,897,289,84,12,16,1298,4-5,1-2,HSSA
E. Bruce Robertson,1081,507,106,14,20,1728,3-4,2-3,HSSA
Earl Stewart,1718,771,245,55,48,2837,3-4,1-2,HSSA
Ednie Garrison,1087,205,81,32,62,1467,4-5,2-3,HSSA
Eduardo Raposo,826,585,174,37,21,1643,3-4,2-3,HSSA
Edward Branigan,84,28,1,0,9,122,3-4,3-4,HSSA
Edward Keller,28,0,0,0,0,28,3-4,2-3,HSSA
Edwina Barvosa,926,1279,302,28,51,2586,2-3,3-4,HSSA
Elaine McLemore,1019,459,115,15,37,1645,4-5,2-3,HSSA
Elana Resnick,1389,307,70,15,45,1826,4-5,1-2,HSSA
Elena Aronova,726,220,43,15,32,1036,4-5,2-3,HSSA
Elena Raymond,3170,1305,311,65,110,4961,3-4,2-3,HSSA
Elena Skapoulli,808,618,202,26,21,1675,3-4,2-3,HSSA
Elide Oliver,294,112,34,13,9,462,3-4,2-3,HSSA
Elieen Boris,655,237,55,10,22,979,3-4,2-3,HSSA
Elisabeth Weber,599,213,54,1,23,890,4-5,2-3,HSSA
Elizabeth Brownson,56,99,37,7,8,207,3-4,2-3,HSSA
Elizabeth Cook,724,635,135,22,34,1550,4-5,3-4,HSSA
Elizabeth Digeser,1112,1324,469,71,160,3136,2-3,3-4,HSSA
Elizabeth Macarthur,381,187,37,4,14,623,2-3,2-3,HSSA
Elizabeth Perez,657,215,37,15,15,939,3-4,2-3,HSSA
Elizabeth Saur,851,221,42,7,19,1140,4-5,2-3,HSSA
Ellen McCracken,238,360,324,164,76,1162,1-2,4-5,HSSA
Ellen O'Connell,81,34,5,0,2,122,4-5,3-4,HSSA
Ellen Whittet,743,186,17,0,17,963,4-5,2-3,HSSA
Ellie Hernandez,1369,683,97,14,43,2206,2-3,2-3,HSSA
Elliot Wolfson,282,178,54,3,51,568,2-3,3-4,HSSA
Elliott Ihm,1205,625,366,96,82,2374,4-5,3-4,HSSA
Emily Engel,440,252,64,5,58,819,2-3,3-4,HSSA
Emily Jacobs,985,446,97,13,8,1549,4-5,2-3,HSSA
Emma Levine,648,188,65,13,24,938,4-5,1-2,HSSA
Emma McCullough,424,300,132,35,37,928,3-4,3-4,HSSA
Emma Parker,1344,238,50,9,25,1666,2-3,2-3,HSSA
Eric Beltz,1270,567,122,30,35,2024,4-5,3-4,HSSA
Eric Campbell,322,178,51,3,13,567,3-4,3-4,HSSA
Eric Engel,440,252,64,5,58,819,4-5,1-2,HSSA
Eric Jorgensen,192,56,11,2,6,267,3-4,3-4,HSSA
Eric McFarland,475,505,206,23,10,1219,2-3,4-5,HSSA
Eric Nebeker,274,243,21,1,4,543,3-4,2-3,HSSA
Eric Prieto,1142,1223,170,15,45,2595,4-5,2-3,HSSA
Eric Smith,1565,1414,420,24,58,3481,4-5,3-4,HSSA
Eric Zackrison,111,99,17,0,4,231,3-4,3-4,HSSA
Erik Nielsen,1453,413,96,37,76,2075,3-4,2-3,HSSA
Erika Felix,1201,325,52,8,9,1595,3-4,3-4,HSSA
Erika Rappaport,1440,1060,225,19,78,2822,4-5,2-3,HSSA
Erin Ninh,1022,1651,361,51,56,3141,3-4,3-4,HSSA
Ernest Sturm,246,308,53,1,13,621,2-3,2-3,HSSA
Esther Lezra,1191,723,197,39,40,2190,2-3,3-4,HSSA
Ethan Hartsell,36,28,5,1,0,70,4-5,3-4,HSSA
Eva Braunstein,201,93,18,4,4,320,4-5,3-4,HSSA
Evelyn Wade,1091,112,25,2,21,1251,4-5,1-2,HSSA
Fabio Rambelli,911,764,250,42,82,2049,3-4,2-3,HSSA
Fatima Suarez,203,84,29,8,21,345,3-4,3-4,HSSA
Felice Blake,1551,1091,146,21,51,2860,4-5,2-3,HSSA
Felicia Lopez,138,117,33,1,12,301,4-5,3-4,HSSA
Fernando Lopez-Alves,1099,647,96,9,14,1865,3-4,2-3,HSSA
Fikret Yegul,379,489,326,84,77,1355,2-3,3-4,HSSA
France Winddance Twine,792,468,169,58,71,1558,2-3,3-4,HSSA
Francis Dunn,3345,3289,1407,249,427,8717,3-4,2-3,HSSA
Francisco Lomeli,137,360,218,27,48,790,2-3,3-4,HSSA
Frank Brown,12,0,0,0,0,12,2-3,3-4,HSSA
Frank Dutra,402,533,133,4,30,1102,3-4,2-3,HSSA
Frank Spera,76,0,0,0,0,76,3-4,3-4,HSSA
Garay Menicucci,188,285,62,2,11,548,3-4,2-3,HSSA
Garrett Glasgow,212,264,110,28,29,643,4-5,2-3,HSSA
Gaye Johnson,1385,801,181,38,54,2459,4-5,2-3,HSSA
Gene Lerner,121,201,134,12,13,481,2-3,3-4,HSSA
Geoff Allen,199,497,105,20,20,841,3-4,3-4,HSSA
Geoffrey Jacques,190,235,32,6,11,474,2-3,3-4,HSSA
Geoffrey Raymond,1035,567,56,9,79,1746,4-5,2-3,HSSA
George Ayoub,111,111,53,18,8,301,2-3,3-4,HSSA
George Blake,288,267,70,15,17,657,2-3,4-5,HSSA
George Lipsitz,767,732,189,22,39,1749,3-4,3-4,HSSA
Gerardo Aldana,722,666,157,15,40,1600,3-4,3-4,HSSA
Giles Gunn,1197,880,200,23,36,2336,2-3,3-4,HSSA
Gina Genova,940,1023,96,10,14,2083,4-5,3-4,HSSA
Gina Vallis,616,298,13,4,32,963,4-5,2-3,HSSA
Giorgina Paiella,23,32,1,0,2,58,4-5,2-3,HSSA
Giuliana Perrone,1568,1455,280,23,117,3443,4-5,2-3,HSSA
Glenn Fredrickson,323,189,34,14,11,571,4-5,3-4,HSSA
Glenn Patten,600,683,425,149,162,2019,3-4,3-4,HSSA
Gordon Abra,4029,1404,378,107,123,6041,3-4,3-4,HSSA
Grace Chang,789,622,153,25,59,1648,3-4,2-3,HSSA
Graciela Limon,203,84,14,1,2,304,4-5,1-2,HSSA
Graham Budgett,336,112,10,3,20,481,3-4,3-4,HSSA
Greg Goalwin,90,85,23,3,5,206,4-5,2-3,HSSA
Greg Hillis,4607,2947,723,125,229,8631,4-5,2-3,HSSA
Greg Jarrett,1368,1038,665,63,115,3249,3-4,3-4,HSSA
Greg Johnson,1385,801,181,38,54,2459,3-4,2-3,HSSA
Greg Mitchell,295,131,31,14,30,501,2-3,3-4,HSSA
Greg Siegel,426,820,449,115,67,1877,3-4,4-5,HSSA
Greg Wilson,656,249,76,15,21,1017,4-5,2-3,HSSA
Gregg Santori,501,515,84,9,41,1150,2-3,3-4,HSSA
Gregory Graves,815,2192,368,5,81,3461,4-5,2-3,HSSA
Gurinder Singh Mann,978,765,106,10,32,1891,4-5,1-2,HSSA
Gustavo Ponce,55,0,0,0,0,55,2-3,3-4,HSSA
Hal Pedersen,13,4,0,0,0,17,2-3,3-4,HSSA
Hala Sun,79,91,10,3,4,187,1-2,4-5,HSSA
Hangping Xu,537,175,49,22,31,814,4-5,2-3,HSSA
Hannah Wohl,436,186,50,5,22,699,3-4,3-4,HSSA
Harold Marcuse,1926,1404,371,64,124,3889,3-4,2-3,HSSA
Harry Reese,282,138,12,2,2,436,3-4,3-4,HSSA
Harvey Sharrer,30,72,9,0,8,119,2-3,2-3,HSSA
Heather Badamo,604,700,192,32,61,1589,2-3,3-4,HSSA
Heather Blurton,858,701,151,21,64,1795,3-4,2-3,HSSA
Heather Stoll,409,472,149,15,24,1069,3-4,3-4,HSSA
Heejung Kim,1554,1598,514,78,49,3793,3-4,2-3,HSSA
Helen Morales,3010,1506,659,114,175,5464,4-5,2-3,HSSA
Helen Taschian,1927,971,281,74,219,3472,3-4,3-4,HSSA
Henry Kim,1554,1598,514,78,49,3793,2-3,2-3,HSSA
Henry Maar,600,642,89,7,46,1384,4-5,2-3,HSSA
Hilal Elver,68,21,6,0,2,97,2-3,2-3,HSSA
Hilary Bernstein,617,800,309,36,74,1836,4-5,3-4,HSSA
Hiroko Sugawara,1140,456,121,17,9,1743,4-5,2-3,HSSA
Holly Roose,1618,52,64,6,39,1779,4-5,1-2,HSSA
Hongbo Yu,754,248,73,21,15,1111,3-4,2-3,HSSA
Howard Giles,793,540,120,18,8,1479,4-5,2-3,HSSA
Howard Winant,1522,2268,688,84,84,4646,2-3,2-3,HSSA
Hsiao-Jung (Sharon) Yu,754,248,73,21,15,1111,3-4,3-4,HSSA
Hua Lee,16,0,0,0,0,16,3-4,3-4,HSSA
Ian Nance,68,194,80,12,7,361,3-4,2-3,HSSA
Ilana Luna,22,11,12,3,1,49,4-5,2-3,HSSA
Ilene Miele,1763,1723,135,11,56,3688,4-5,1-2,HSSA
Ines Talamantez,1096,519,84,20,46,1765,2-3,2-3,HSSA
Ingrid Banks,264,682,567,207,358,2078,2-3,4-5,HSSA
Ingrid Bowman,481,359,47,9,12,908,3-4,3-4,HSSA
Ingrid Li,23,46,15,2,3,89,4-5,3-4,HSSA
Irina Wender,120,119,23,7,10,279,3-4,3-4,HSSA
Irwin Appel,1691,136,7,3,11,1848,4-5,2-3,HSSA
Isabella Restrepo,377,77,14,7,8,483,4-5,2-3,HSSA
Ivanne Deneroff,127,57,13,0,0,197,2-3,4-5,HSSA
J J Kearney,2003,1246,227,23,49,3548,4-5,2-3,HSSA
J. Sears McGee,278,566,320,42,70,1276,3-4,3-4,HSSA
Jack Miller,45,7,1,0,0,53,4-5,2-3,HSSA
Jackson Warkentin,670,446,158,8,46,1328,4-5,2-3,HSSA
Jacqueline Apodaca,228,73,22,6,15,344,4-5,1-2,HSSA
Jacqueline Bobo,1739,1106,439,76,85,3445,4-5,2-3,HSSA
Jaime Alves,561,321,73,27,61,1043,2-3,3-4,HSSA
James Donelan,1815,1027,66,2,71,2981,3-4,2-3,HSSA
James McNamara,542,602,39,8,13,1204,4-5,3-4,HSSA
James Roney,917,1507,991,143,104,3662,3-4,3-4,HSSA
Jan Frodesen,406,166,35,3,3,613,4-5,3-4,HSSA
Jane Callister,621,166,8,5,5,805,4-5,2-3,HSSA
Jane Duran,411,228,20,4,6,669,3-4,2-3,HSSA
Janet Afary,835,427,103,47,51,1463,3-4,3-4,HSSA
Janet Mizrahi,937,934,76,11,25,1983,3-4,3-4,HSSA
Janet Walker,408,89,8,2,9,516,4-5,2-3,HSSA
Janis Caldwell,410,171,25,9,9,624,4-5,1-2,HSSA
Janna Haider,13,8,1,0,1,23,3-4,2-3,HSSA
Jaqueline Bobo,1739,1106,439,76,85,3445,2-3,2-3,HSSA
Jared Holton,669,173,47,10,22,921,4-5,1-2,HSSA
Jarett Henderson,1211,429,114,34,76,1864,3-4,3-4,HSSA
Jason Duque,1729,359,111,34,58,2291,2-3,2-3,HSSA
Jason Raley,2195,341,81,12,17,2646,4-5,2-3,HSSA
Jason Stohler,863,519,67,0,27,1476,4-5,1-2,HSSA
Jason Turowetz,849,600,167,30,59,1705,4-5,1-2,HSSA
Jean Carlson,768,895,153,8,41,1865,2-3,4-5,HSSA
Jean Schultz,1093,906,266,53,60,2378,3-4,3-4,HSSA
Jeanette Peterson,312,345,107,13,26,803,3-4,3-4,HSSA
Jeannine Delombard,342,442,186,73,110,1153,2-3,4-5,HSSA
Jedrzej Kozerawski,26,1,0,0,0,27,3-4,3-4,HSSA
Jeff Bagwell,251,286,77,5,15,634,3-4,2-3,HSSA
Jeffrey Hanson,3205,2080,174,10,83,5552,4-5,3-4,HSSA
Jeffrey Hehmeyer,32,21,2,0,2,57,4-5,2-3,HSSA
Jeffrey Hoelle,1908,2332,451,81,87,4859,3-4,2-3,HSSA
Jeffrey Stewart,1253,691,131,32,44,2151,4-5,2-3,HSSA
Jeffrey Stopple,393,1,0,0,1,395,3-4,3-4,HSSA
Jen Martin,139,200,46,11,16,412,3-4,2-3,HSSA
Jennifer Earl,122,110,45,16,15,308,3-4,3-4,HSSA
Jennifer Gibbs,801,367,26,1,7,1202,4-5,2-3,HSSA
Jennifer Hamilton,681,1015,362,56,51,2165,4-5,2-3,HSSA
Jennifer Holt,673,1274,462,46,73,2528,4-5,3-4,HSSA
Jennifer Johnson,1756,1032,190,33,64,3075,4-5,2-3,HSSA
Jennifer Kam,675,779,240,41,17,1752,4-5,2-3,HSSA
Jennifer King,84,43,19,4,6,156,4-5,2-3,HSSA
Jennifer Tyburczy,1198,102,24,5,22,1351,4-5,2-3,HSSA
Jennifer Vanderpool,868,197,33,2,28,1128,2-3,2-3,HSSA
Jennifer Wicke,1504,108,19,9,20,1660,4-5,1-2,HSSA
Jeremy Douglass,986,750,146,21,31,1934,3-4,2-3,HSSA
Jeremy Moore,50,55,6,0,3,114,4-5,3-4,HSSA
Jeremy White,2498,1338,335,73,125,4369,3-4,3-4,HSSA
Jessica Feezell,91,185,87,16,15,394,4-5,2-3,HSSA
Jessica Nakamura,1272,241,53,14,33,1613,4-5,2-3,HSSA
Jessica Valadez,123,9,0,0,0,132,4-5,1-2,HSSA
Jessica Zisa,203,45,11,4,11,274,1-2,3-4,HSSA
Jia-Ching Chen,329,427,207,27,62,1052,1-2,4-5,HSSA
Jillian Fischer,890,224,62,13,64,1253,3-4,2-3,HSSA
Jillian Mullen,281,97,22,8,8,416,3-4,3-4,HSSA
Jim Lee,2320,1473,412,82,139,4426,3-4,2-3,HSSA
Jingrun Chen,329,427,207,27,62,1052,3-4,2-3,HSSA
Jo Ann Shelton,27,37,11,2,2,79,3-4,2-3,HSSA
Jocelyn Holland,908,379,74,10,26,1397,3-4,2-3,HSSA
Jody Enders,363,579,102,10,21,1075,2-3,3-4,HSSA
Joe Chada,781,586,160,22,18,1567,4-5,3-4,HSSA
Joe Walther,417,136,72,21,10,656,4-5,3-4,HSSA
Joe Zasadzinski,19,36,21,1,0,77,2-3,4-5,HSSA
Joel Hunt,123,75,35,7,18,258,4-5,2-3,HSSA
John Baldwin,22697,16780,10848,1257,1880,53462,3-4,3-4,HSSA
John Catalini,298,256,9,3,4,570,3-4,1-2,HSSA
John Foran,2924,294,30,5,42,3295,4-5,2-3,HSSA
John Hajda,499,432,173,36,15,1155,3-4,3-4,HSSA
John Hartman,10,0,0,0,0,10,2-3,3-4,HSSA
John Johnson,1756,1032,190,33,64,3075,2-3,3-4,HSSA
John Latto,45,9,3,1,5,63,4-5,2-3,HSSA
John Lee,2320,1473,412,82,139,4426,4-5,3-4,HSSA
John Majewski,911,1242,343,35,65,2596,4-5,2-3,HSSA
John Mohr,868,453,102,10,20,1453,3-4,1-2,HSSA
John Moore,50,55,6,0,3,114,4-5,2-3,HSSA
John Nathan,2839,550,171,21,75,3656,3-4,2-3,HSSA
John Robertson,405,168,23,3,10,609,3-4,3-4,HSSA
John Schranck,432,94,25,3,14,568,4-5,2-3,HSSA
John Soboslai,211,255,77,29,13,585,3-4,2-3,HSSA
John Sutton,1076,1170,162,19,39,2466,4-5,2-3,HSSA
John Talbott,156,168,48,2,5,379,3-4,2-3,HSSA
John Tooby,987,916,289,66,21,2279,3-4,2-3,HSSA
John Woolley,397,943,292,43,74,1749,2-3,3-4,HSSA
Jon Cruz,828,823,228,30,61,1970,4-5,2-3,HSSA
Jon Nathan,2839,550,171,21,75,3656,3-4,3-4,HSSA
Jon Ramsey,368,194,19,6,1,588,4-5,2-3,HSSA
Jon Snyder,352,371,133,12,37,905,4-5,3-4,HSSA
Jonathan Forbes,169,120,19,4,5,317,4-5,2-3,HSSA
Jonathan Schooler,1858,2439,1594,411,185,6487,3-4,3-4,HSSA
Jordan Clark,297,233,106,20,11,667,2-3,3-4,HSSA
Jordan Victorian,363,87,26,7,23,506,3-4,2-3,HSSA
Jorge Checa,519,385,78,6,6,994,3-4,2-3,HSSA
Jorge Luis Castillo,729,430,167,34,51,1411,4-5,3-4,HSSA
Jose Cabezon,525,289,129,32,40,1015,4-5,2-3,HSSA
Jose Valente,22,51,21,3,2,99,3-4,2-3,HSSA
Joseph Blankholm,768,390,105,22,54,1339,4-5,3-4,HSSA
Josh May,16,75,31,10,9,141,4-5,3-4,HSSA
Josh Smith,86,65,15,5,14,185,4-5,2-3,HSSA
Joshua Moss,185,344,97,2,16,644,4-5,2-3,HSSA
Jovana Gomez,428,141,34,15,18,636,2-3,3-4,HSSA
Joyce King,84,43,19,4,6,156,1-2,3-4,HSSA
Juan Campo,419,479,163,55,69,1185,3-4,3-4,HSSA
Juan Pablo Lupi,930,782,158,25,69,1964,3-4,3-4,HSSA
Jude Akudinobi,3265,1982,218,30,139,5634,3-4,2-3,HSSA
Judith Green,140,5,0,0,1,146,1-2,2-3,HSSA
Julia Morse,389,509,167,26,24,1115,4-5,3-4,HSSA
Julie Carlson,768,895,153,8,41,1865,4-5,2-3,HSSA
Julissa Pena,4,10,6,1,0,21,4-5,2-3,HSSA
Justin Pearson,332,27,7,2,3,371,4-5,2-3,HSSA
Justine Meyr,417,37,12,4,11,481,4-5,2-3,HSSA
Kai Thaler,624,198,39,11,8,880,4-5,2-3,HSSA
Kali Yamboliev,317,493,27,2,28,867,2-3,3-4,HSSA
Kana Pierce,399,143,47,13,5,607,4-5,2-3,HSSA
Kane Anderson,15,3,0,0,0,18,4-5,2-3,HSSA
Kara Attrep,257,115,22,7,9,410,4-5,1-2,HSSA
Kara Mae Brown,59,16,11,1,2,89,4-5,3-4,HSSA
Karen Lunsford,546,120,4,1,4,675,4-5,2-3,HSSA
Karen Myers,1186,1691,535,42,32,3486,4-5,2-3,HSSA
Karen Szumlinski,1906,1201,682,105,82,3976,4-5,3-4,HSSA
Kasie Mays,371,170,37,11,14,603,2-3,3-4,HSSA
Kate McDonald,746,312,94,11,20,1183,4-5,2-3,HSSA
Katerina Ford,520,393,292,108,61,1374,1-2,3-4,HSSA
Katharina Schreiber,267,132,46,8,7,460,4-5,2-3,HSSA
Katherine Saltzman-Li,979,692,256,41,85,2053,2-3,3-4,HSSA
Kathleen Bruhn,977,1730,617,86,68,3478,3-4,3-4,HSSA
Kathy Foltz,134,11,1,0,1,147,4-5,3-4,HSSA
Kathy Patterson,857,1095,210,25,69,2256,4-5,2-3,HSSA
Katia McClain,2010,530,70,12,24,2646,4-5,1-2,HSSA
Katie Baillargeon,2499,623,98,9,85,3314,4-5,2-3,HSSA
Katie Moore,3003,876,156,53,92,4180,4-5,1-2,HSSA
Kay Young,910,619,67,8,31,1635,4-5,3-4,HSSA
Kayla McLaughlin,2,5,1,1,1,10,4-5,3-4,HSSA
Keith Corona,762,198,36,4,6,1006,4-5,2-3,HSSA
Ken Hough,81,127,47,2,9,266,3-4,2-3,HSSA
Ken Millett,18,0,0,0,0,18,2-3,3-4,HSSA
Kendra Calhoun,132,61,20,7,8,228,4-5,2-3,HSSA
Kenneth (Ken) Hiltner,7058,4780,1855,427,402,14522,3-4,2-3,HSSA
Kenneth Kosik,172,117,53,9,5,356,3-4,3-4,HSSA
Kenneth Smith,1239,352,34,1,26,1652,4-5,2-3,HSSA
Kevin Anderson,15,3,0,0,0,18,3-4,2-3,HSSA
Kevin Falvey,414,772,521,50,124,1881,2-3,3-4,HSSA
Kevin Hatcher,1927,1430,288,39,49,3733,4-5,2-3,HSSA
Kevin Kearney,110,70,7,0,8,195,4-5,2-3,HSSA
Kevin McBrien,1048,178,38,8,21,1293,4-5,1-2,HSSA
Kevin Moore,3003,876,156,53,92,4180,4-5,2-3,HSSA
Kevin Rutherford,795,156,23,16,16,1006,4-5,2-3,HSSA
Kevin Whitehead,695,267,43,6,27,1038,4-5,3-4,HSSA
Kim Yasuda,1793,227,31,6,25,2082,3-4,2-3,HSSA
Kristy Hamilton,763,407,68,14,11,1263,4-5,2-3,HSSA
Kristy Slominski,66,96,43,10,9,224,4-5,1-2,HSSA
Krzysztof Janowicz,9,0,0,0,0,9,4-5,3-4,HSSA
Kum Kum Bhavnani,779,292,17,5,22,1115,4-5,2-3,HSSA
Kyle Dickey,130,248,80,12,23,493,3-4,3-4,HSSA
Kyle Ratner,1151,529,215,35,50,1980,4-5,2-3,HSSA
Lal Zimman,894,275,69,11,28,1277,4-5,2-3,HSSA
Larry McLellan,1105,357,45,9,25,1541,4-5,2-3,HSSA
Laura Jansma,1821,2161,331,41,42,4396,3-4,2-3,HSSA
Laura Kalman,3420,3128,445,27,134,7154,4-5,2-3,HSSA
Laura Robinson,195,77,39,12,20,343,4-5,1-2,HSSA
Laura Romo,1027,297,93,15,13,1445,1-2,3-4,HSSA
Laura Tanner,179,105,41,7,26,358,2-3,2-3,HSSA
Laurel Beckman,341,314,100,21,25,801,3-4,3-4,HSSA
Laurence Rickels,52,70,1,0,5,128,2-3,2-3,HSSA
Laurie Freeman,1380,930,143,26,26,2505,2-3,2-3,HSSA
Laurie Monahan,1162,1714,484,43,77,3480,3-4,3-4,HSSA
Laury Oaks,926,741,169,17,41,1894,4-5,3-4,HSSA
Leah Fernandez,253,277,104,21,23,678,2-3,3-4,HSSA
Leah Stokes,352,411,116,22,30,931,4-5,3-4,HSSA
Leda Cosmides,1188,1223,527,107,35,3080,3-4,2-3,HSSA
Lee Rothfarb,200,126,34,9,7,376,2-3,3-4,HSSA
Leigh Elion,290,74,3,0,3,370,4-5,2-3,HSSA
Leila Rupp,760,729,158,15,40,1702,4-5,2-3,HSSA
Leslie Hammer,917,1015,76,6,35,2049,4-5,3-4,HSSA
Li-C Wang,29,36,4,0,2,71,4-5,1-2,HSSA
Liberty Stanavage,9,19,3,0,0,31,4-5,2-3,HSSA
Lily Anne Yumi Welty,340,279,87,12,43,761,3-4,4-5,HSSA
Lina Kim,1471,59,5,0,1,1536,2-3,3-4,HSSA
Linda Juang,841,874,408,121,80,2324,3-4,2-3,HSSA
Linda Petzold,5,3,0,0,0,8,2-3,3-4,HSSA
Linda Putnam,121,191,94,16,6,428,3-4,3-4,HSSA
Lisa Avery,147,151,32,4,5,339,3-4,3-4,HSSA
Lisa Jacobson,905,1270,259,14,52,2500,4-5,3-4,HSSA
Lisa McAllister,140,183,70,11,19,423,2-3,3-4,HSSA
Lisa Park,971,433,135,25,40,1604,4-5,2-3,HSSA
Lisa Parks,315,555,277,9,25,1181,4-5,3-4,HSSA
Ljiljana Coklin,1490,1076,98,3,47,2714,3-4,3-4,HSSA
Lorelei Moosbrugger,551,895,216,10,27,1699,4-5,3-4,HSSA
Lori Pye,8,0,0,0,0,8,4-5,1-2,HSSA
Lorraine McDonnell,271,579,126,11,31,1018,4-5,3-4,HSSA
Louis Caron,184,179,37,6,20,426,4-5,3-4,HSSA
Luc Jaeger,14,4,0,0,0,18,2-3,2-3,HSSA
Luis Hernandez,108,89,25,2,3,227,4-5,1-2,HSSA
Luke Janes,385,37,6,1,8,437,4-5,1-2,HSSA
Luke Roberts,2051,1408,405,57,131,4052,4-5,2-3,HSSA
Lynn Gamble,729,600,369,95,73,1866,3-4,3-4,HSSA
Madeline Sorapure,817,219,19,3,4,1062,4-5,2-3,HSSA
Magda Campo,936,643,213,77,48,1917,4-5,2-3,HSSA
Manny Kundu,196,460,302,49,21,1028,3-4,2-3,HSSA
Manuel Covo,732,455,69,14,50,1320,3-4,3-4,HSSA
Marc Becker,8,27,4,1,2,42,2-3,3-4,HSSA
Marguerite Nash,607,1277,362,31,61,2338,3-4,3-4,HSSA
Maria Crickette,1018,589,220,42,51,1920,4-5,2-3,HSSA
Marianne Mithun,793,195,97,51,31,1167,3-4,2-3,HSSA
Marie Webb,345,215,26,0,10,596,2-3,4-5,HSSA
Mario Galicia,867,290,91,19,40,1307,3-4,2-3,HSSA
Mario Garcia,2603,1863,346,50,53,4915,3-4,2-3,HSSA
Marion Labatut,842,521,121,18,27,1529,4-5,2-3,HSSA
Marjorie Kruvand,378,172,31,9,12,602,2-3,3-4,HSSA
Mark Maslan,1161,1051,264,43,99,2618,3-4,3-4,HSSA
Mark Meadow,1356,844,248,15,83,2546,3-4,2-3,HSSA
Mark Rose,757,1082,228,29,42,2138,4-5,2-3,HSSA
Mark Shishim,3378,908,79,1,33,4399,4-5,2-3,HSSA
Martha Webber,825,347,79,16,76,1343,4-5,2-3,HSSA
Martin Stokes,786,173,26,6,7,998,3-4,1-2,HSSA
Mary Bucholtz,1914,478,140,34,51,2617,4-5,1-2,HSSA
Mary Furner,225,227,166,35,43,696,3-4,3-4,HSSA
Mary Hancock,171,117,82,14,16,400,2-3,3-4,HSSA
Mary Hegarty,888,761,301,72,40,2062,3-4,3-4,HSSA
Mary O'Connor,9,23,13,1,3,49,2-3,1-2,HSSA
Maryam Majedi,15,0,0,0,0,15,1-2,4-5,HSSA
Mashey Bernstein,360,663,97,15,16,1151,3-4,3-4,HSSA
Matt Gordon,1810,936,183,22,40,2991,4-5,1-2,HSSA
Matt Whittle,912,1325,507,121,88,2953,4-5,2-3,HSSA
Matthea Cremers,210,182,64,19,16,491,3-4,2-3,HSSA
Matthew Curtis,16,24,6,8,1,55,4-5,3-4,HSSA
Matthew Hanser,443,1109,546,51,80,2229,4-5,3-4,HSSA
Matthew Helgeson,636,499,158,47,36,1376,4-5,3-4,HSSA
Matthew Roy,1100,350,76,14,31,1571,4-5,1-2,HSSA
Matthew Whittle,912,1325,507,121,88,2953,4-5,2-3,HSSA
Maud Maillard,429,155,35,8,7,634,4-5,2-3,HSSA
Maurizia Boscagli,2097,1041,218,21,83,3460,3-4,3-4,HSSA
Mavel Marina,232,34,14,1,2,283,1-2,2-3,HSSA
Mayfair Yang,963,865,282,32,50,2192,3-4,2-3,HSSA
Meagan Carter,22,61,33,7,9,132,2-3,3-4,HSSA
Megan Fernandes,21,42,3,2,3,71,4-5,2-3,HSSA
Melinda Baham,560,396,100,8,16,1080,3-4,2-3,HSSA
Melissa Curtin,631,1048,467,63,41,2250,3-4,3-4,HSSA
Melody Jue,974,210,42,2,29,1257,4-5,3-4,HSSA
Mhoze Chikowero,772,601,112,21,61,1567,3-4,2-3,HSSA
Mia White,158,154,16,2,9,339,3-4,3-4,HSSA
Michael Berry,444,287,96,14,23,864,4-5,2-3,HSSA
Michael Goard,195,141,10,1,3,350,4-5,3-4,HSSA
Michael Gordon,1810,936,183,22,40,2991,4-5,3-4,HSSA
Michael Gurven,380,316,181,70,52,999,3-4,3-4,HSSA
Michael Jochim,234,284,163,45,26,752,4-5,2-3,HSSA
Michael Miller,818,839,726,167,65,2615,3-4,3-4,HSSA
Michael Mrazek,245,189,74,18,8,534,4-5,1-2,HSSA
Michael O'Connell,53,93,58,9,8,221,3-4,3-4,HSSA
Michael Petracca,210,9,3,2,2,226,4-5,1-2,HSSA
Michael Rescorla,116,323,307,32,38,816,3-4,3-4,HSSA
Michael Shahandeh,24,4,0,0,0,28,3-4,4-5,HSSA
Michael Stohl,689,710,89,5,37,1530,2-3,3-4,HSSA
Michelle Brown,447,339,163,68,42,1059,2-3,4-5,HSSA
Miguel Eckstein,1165,928,260,37,31,2421,4-5,3-4,HSSA
Mikael Gayen,68,78,35,11,11,203,4-5,3-4,HSSA
Mike Joiner,451,368,157,32,30,1038,4-5,1-2,HSSA
Miller Young,25,3,0,0,3,31,4-5,1-2,HSSA
Minwoo Park,28,3,0,0,1,32,2-3,4-5,HSSA
Miriam Metzger,756,1027,707,306,193,2989,3-4,3-4,HSSA
Miriam Wattles,790,307,11,2,25,1135,3-4,2-3,HSSA
Mitchell Kauffman,285,236,93,19,11,644,4-5,3-4,HSSA
Mona Damluji,213,78,7,1,4,303,3-4,3-4,HSSA
Monica Lomeli,64,49,12,1,2,128,3-4,3-4,HSSA
Monica Orozco,38,100,63,21,7,229,2-3,3-4,HSSA
Morgan Davies,542,176,55,13,19,805,4-5,2-3,HSSA
Morgan Gainer,10,0,0,0,0,10,3-4,4-5,HSSA
Muniba Saleem,805,161,33,10,7,1016,4-5,2-3,HSSA
Munther Alsabagh,341,327,101,30,34,833,3-4,3-4,HSSA
Nadege Clitandre,1074,784,285,49,68,2260,2-3,3-4,HSSA
Nancy Collins,990,407,192,37,22,1648,4-5,2-3,HSSA
Nancy Gallagher,38,22,9,0,2,71,2-3,3-4,HSSA
Nathan Salmon,365,281,280,122,206,1254,3-4,3-4,HSSA
Naz Keynejad,148,44,12,2,0,206,4-5,2-3,HSSA
Neil Narang,784,789,146,19,30,1768,4-5,3-4,HSSA
Nicolas Jurkowski,2647,759,274,92,141,3913,4-5,2-3,HSSA
Nicolasa Sandoval,1302,41,5,5,9,1362,4-5,1-2,HSSA
Nicole Albada,2158,1063,241,44,47,3553,4-5,3-4,HSSA
Nicole Filler,113,124,20,1,10,268,3-4,2-3,HSSA
Nicole Warwick,1910,760,100,13,85,2868,4-5,2-3,HSSA
Nikki Jones,171,125,39,13,4,352,4-5,2-3,HSSA
Nikki Truscelli,1191,1149,150,29,48,2567,4-5,2-3,HSSA
Noah Friedkin,724,335,108,4,55,1226,2-3,2-3,HSSA
Noah Segal,568,298,94,19,42,1021,4-5,2-3,HSSA
Norah Dunbar,1791,754,217,49,33,2844,4-5,2-3,HSSA
Norbert Reich,22,0,0,0,0,22,2-3,4-5,HSSA
Nuha Khoury,469,646,271,62,121,1569,2-3,3-4,HSSA
Olivia Walling,236,357,113,16,21,743,2-3,4-5,HSSA
Orville Sandall,104,196,57,1,1,359,2-3,3-4,HSSA
Oscar Gil,216,119,30,7,7,379,2-3,2-3,HSSA
Oscar Soto,438,81,12,7,15,553,4-5,3-4,HSSA
Paasha Mahdavi,371,266,92,28,6,763,4-5,3-4,HSSA
Paige Digeser,516,1312,634,80,82,2624,3-4,3-4,HSSA
Patricia Clancy,238,147,54,12,11,462,4-5,2-3,HSSA
Patricia Cohen,229,689,176,9,28,1131,3-4,3-4,HSSA
Patricia Fancher,1109,248,35,6,25,1423,3-4,3-4,HSSA
Patricia Hall,70,32,3,0,1,106,4-5,1-2,HSSA
Patricia Morland,114,46,5,0,3,168,4-5,2-3,HSSA
Patricia Taber,201,129,129,13,25,497,3-4,3-4,HSSA
Patrick McHugh,2307,614,36,4,30,2991,4-5,2-3,HSSA
Paul Amar,1476,727,140,36,86,2465,3-4,3-4,HSSA
Paul Atzberger,43,0,0,0,0,43,2-3,2-3,HSSA
Paul Bambach,1661,5,1,0,2,1669,4-5,1-2,HSSA
Paul Kovacs,347,104,15,2,0,468,3-4,2-3,HSSA
Paul Portuges,306,93,18,1,11,429,4-5,1-2,HSSA
Paul Sonnino,479,437,292,72,156,1436,2-3,3-4,HSSA
Paul Spickard,2173,2515,502,37,200,5427,3-4,3-4,HSSA
Pavel Oleinikov,221,641,240,42,39,1183,3-4,3-4,HSSA
Pavneet Aulakh,14,36,11,2,2,65,4-5,3-4,HSSA
Pei-Te Lien,794,1195,653,146,92,2880,2-3,3-4,HSSA
Pekka Hamalainen,96,42,2,2,2,144,4-5,1-2,HSSA
Peter Aguilar,184,71,33,9,16,313,4-5,2-3,HSSA
Peter Alagona,387,116,32,2,4,541,4-5,2-3,HSSA
Peter Bloom,450,520,143,21,44,1178,2-3,3-4,HSSA
Peter Collins,0,0,0,0,1,1,3-4,3-4,HSSA
Peter Huk,2607,602,35,8,46,3298,4-5,1-2,HSSA
Peter Sturman,893,856,129,2,41,1921,3-4,3-4,HSSA
Phil Murphy,317,183,74,25,23,622,3-4,2-3,HSSA
Philip Lubin,25,1,0,0,0,26,2-3,2-3,HSSA
Philip McCarty,4601,1724,200,33,76,6634,4-5,1-2,HSSA
Quentin Gee,356,748,203,14,52,1373,4-5,2-3,HSSA
Rachael King,600,413,69,8,62,1152,2-3,3-4,HSSA
Rachel Feldman,260,104,20,2,27,413,4-5,2-3,HSSA
Raisa Feldman,260,104,20,2,27,413,2-3,3-4,HSSA
Ralph Armbruster,2704,2046,336,51,102,5239,3-4,2-3,HSSA
Ralph Gallucci,13870,3124,1120,125,202,18441,4-5,1-2,HSSA
Randalyn Browning,2625,1678,186,14,76,4579,4-5,2-3,HSSA
Randy Bergstrom,1262,1504,345,30,94,3235,3-4,3-4,HSSA
Randy Corpuz,601,222,44,8,1,876,4-5,2-3,HSSA
Raymond Clemencon,1419,1270,435,72,108,3304,3-4,3-4,HSSA
Raziel Davison,549,214,40,11,32,846,4-5,3-4,HSSA
Rebecca Chenoweth,731,422,46,2,20,1221,4-5,3-4,HSSA
Rebecca Powers,500,169,50,13,18,750,1-2,2-3,HSSA
Regina Longo,13,57,9,2,3,84,3-4,2-3,HSSA
Reginald Daniel,540,347,69,16,76,1048,4-5,3-4,HSSA
Renan Larue,682,482,119,18,40,1341,3-4,3-4,HSSA
Rene Weber,1515,1849,638,152,139,4293,3-4,2-3,HSSA
Renee Houston,240,266,40,3,3,552,2-3,3-4,HSSA
Rich Powell,885,1032,373,31,44,2365,4-5,2-3,HSSA
Richard Appelbaum,683,1007,517,119,70,2396,4-5,3-4,HSSA
Richard Gramzow,251,84,9,0,1,345,4-5,1-2,HSSA
Richard Hecht,2211,2154,796,22,170,5353,3-4,2-3,HSSA
Richard Mayer,1875,1328,378,61,34,3676,3-4,2-3,HSSA
Richard Rader,507,548,182,34,29,1300,4-5,1-2,HSSA
Richard Widick,133,103,7,1,6,250,3-4,3-4,HSSA
Richard Wittman,672,986,380,31,68,2137,3-4,3-4,HSSA
Rick Benjamin,678,37,6,0,2,723,4-5,1-2,HSSA
Rick Stoody,469,635,245,61,38,1448,4-5,2-3,HSSA
Risa Brainin,1560,200,34,3,6,1803,4-5,2-3,HSSA
Rita Raley,729,1202,149,9,36,2125,4-5,3-4,HSSA
Rob Wallace,54,3,0,0,3,60,4-5,2-3,HSSA
Robert (Bob) Kennedy,5267,3161,1328,421,429,10606,4-5,2-3,HSSA
Robert Krut,2123,467,20,0,17,2627,4-5,2-3,HSSA
Robert L. Koegel,1227,250,40,0,4,1521,4-5,2-3,HSSA
Robert Samuels,954,884,40,1,31,1910,3-4,2-3,HSSA
Roberto Strongman,2060,1268,297,62,154,3841,3-4,3-4,HSSA
Robin Nabi,765,1654,979,194,54,3646,3-4,4-5,HSSA
Rodrigo Bauler,71,5,0,0,0,76,4-5,1-2,HSSA
Ron Keiflin,676,303,60,14,12,1065,4-5,3-4,HSSA
Ronald Egan,177,156,64,10,7,414,3-4,3-4,HSSA
Ronald Rice,854,640,98,8,11,1611,4-5,3-4,HSSA
Rosana Ceniceros,188,268,108,20,28,612,4-5,3-4,HSSA
Ross Melnick,421,448,77,11,30,987,4-5,2-3,HSSA
Rudolph Ware,655,277,37,5,33,1007,3-4,3-4,HSSA
Rudy Busto,1990,1149,376,55,109,3679,4-5,2-3,HSSA
Russell Revlin,656,1445,907,164,81,3253,3-4,3-4,HSSA
Russell Samolsky,596,450,10,0,22,1078,4-5,3-4,HSSA
Ryan Abrecht,165,172,49,3,14,403,4-5,2-3,HSSA
Ryan Boyd,196,264,46,5,12,523,4-5,3-4,HSSA
Ryan Minor,187,45,4,1,1,238,4-5,2-3,HSSA
Sabine Fruhstuck,1852,1262,414,113,109,3750,3-4,2-3,HSSA
Sabrina Curran,153,233,164,62,63,675,4-5,3-4,HSSA
Sahaj Parikh,63,3,0,0,0,66,4-5,2-3,HSSA
Salim Yaqub,2219,2402,370,22,91,5104,4-5,2-3,HSSA
Sam Zahn,194,285,79,5,25,588,4-5,2-3,HSSA
Samanta de Frutos Garcia,261,19,11,2,1,294,4-5,2-3,HSSA
Samantha Daly,11,10,3,0,0,24,3-4,3-4,HSSA
Samantha Scudder,1476,614,183,39,32,2344,4-5,2-3,HSSA
Sameer Pandya,3773,3378,730,64,176,8121,3-4,3-4,HSSA
Samir Mitragotri,274,384,92,1,21,772,4-5,2-3,HSSA
Sandra Thompson,58,23,3,0,1,85,4-5,3-4,HSSA
Sara Lindheim,501,225,69,9,33,837,4-5,2-3,HSSA
Sara Pankenier Weld,816,572,51,4,35,1478,4-5,1-2,HSSA
Sara Wheeler,358,126,28,3,5,520,4-5,2-3,HSSA
Sarah Boggs,153,69,14,2,7,245,4-5,1-2,HSSA
Sarah Case,262,874,349,29,58,1572,3-4,3-4,HSSA
Sarah Cline,317,468,122,6,24,937,3-4,3-4,HSSA
Sarah Harris,208,36,8,3,2,257,4-5,2-3,HSSA
Sarah Hirsch,1763,347,26,1,29,2166,4-5,2-3,HSSA
Sarah McClure,981,319,129,29,51,1509,4-5,2-3,HSSA
Sarah Roberts,2143,962,219,45,68,3437,4-5,2-3,HSSA
Sarah Thompson,58,23,3,0,1,85,3-4,3-4,HSSA
Sarah Watkins,224,160,30,5,19,438,4-5,2-3,HSSA
Scott Dirkse,636,222,70,17,18,963,4-5,1-2,HSSA
Scott Englund,301,544,120,19,22,1006,3-4,2-3,HSSA
Scott Grafton,393,225,142,39,14,813,4-5,3-4,HSSA
Scott Marcus,1407,415,104,19,107,2052,3-4,1-2,HSSA
Scott Reid,965,1170,325,3,43,2506,3-4,3-4,HSSA
Sergey Salushchev,83,13,5,0,0,101,4-5,3-4,HSSA
Shae Miller,100,112,32,5,12,261,2-3,3-4,HSSA
Shankar Aswani,84,92,50,21,13,260,2-3,3-4,HSSA
Shanna Salinas,29,18,1,0,2,50,4-5,2-3,HSSA
Shannon Meyer,37,60,14,0,6,117,2-3,3-4,HSSA
Sharon Farmer,210,303,80,0,17,610,2-3,3-4,HSSA
Shelley LaMon,321,237,78,10,16,662,3-4,2-3,HSSA
Shelly Gable,2792,2378,823,160,81,6234,4-5,2-3,HSSA
Sherene Seikaly,1047,292,58,9,37,1443,4-5,3-4,HSSA
Shinder Thandi,955,1136,234,38,38,2401,3-4,2-3,HSSA
Shirley Lim,343,219,33,3,11,609,3-4,2-3,HSSA
Shu-Chuan (Bella) Chen,1928,586,149,34,70,2767,4-5,2-3,HSSA
Siddharth Dey,330,262,146,23,8,769,2-3,3-4,HSSA
Silke Werth,961,261,75,13,26,1336,4-5,2-3,HSSA
Silvia Bermudez,1442,376,73,10,27,1928,3-4,2-3,HSSA
Simon Williams,708,636,124,14,46,1528,4-5,3-4,HSSA
Simonetta Falasca,1144,615,118,16,27,1920,3-4,2-3,HSSA
Skirmantas Janusonis,2503,1429,566,137,127,4762,4-5,3-4,HSSA
Smaranda Lawrie,136,74,16,1,1,228,4-5,3-4,HSSA
Sowon Park,576,213,70,24,22,905,4-5,3-4,HSSA
Stan Anderson,12,0,0,0,0,12,3-4,3-4,HSSA
Stan Rauh,27,20,2,2,2,53,2-3,3-4,HSSA
Stanley Klein,2725,4208,1940,477,178,9528,4-5,2-3,HSSA
Stefan Gries,368,117,48,16,35,584,2-3,3-4,HSSA
Stefania Tutino,309,715,250,13,59,1346,4-5,3-4,HSSA
Stefanie Tcharos,499,310,117,43,14,983,4-5,3-4,HSSA
Stephan Miescher,566,492,110,17,47,1232,3-4,3-4,HSSA
Stephanie Batiste,392,426,179,42,48,1087,2-3,3-4,HSSA
Stephanie Lemenager,393,283,24,5,17,722,4-5,2-3,HSSA
Stephanie Malia Hom,529,155,33,6,21,744,4-5,1-2,HSSA
Stephanie Washburn,138,206,29,2,18,393,4-5,3-4,HSSA
Stephen Zylstra,759,1068,296,36,46,2205,4-5,2-3,HSSA
Steve Allaback,77,30,5,1,2,115,4-5,1-2,HSSA
Steve Pokornowski,95,111,10,1,4,221,3-4,3-4,HSSA
Steve Wiener,128,355,118,10,39,650,2-3,3-4,HSSA
Steven Canet,427,277,63,10,29,806,4-5,2-3,HSSA
Steven Gaulin,2821,3943,2783,1161,969,11677,3-4,3-4,HSSA
Steven Humphrey,88,224,146,13,34,505,3-4,3-4,HSSA
Steven Osuna,111,38,8,1,3,161,4-5,1-2,HSSA
Stuart Smith,2745,1484,517,151,291,5188,2-3,3-4,HSSA
Summer Gray,154,113,15,0,8,290,4-5,2-3,HSSA
Summer Star,232,95,5,0,3,335,4-5,3-4,HSSA
Sunny Jung,24,2,0,0,0,26,4-5,1-2,HSSA
Susan Ceriale,328,153,54,5,9,549,3-4,2-3,HSSA
Susan Derwin,784,386,75,6,29,1280,3-4,3-4,HSSA
Susan Kuzminsky,4,5,0,0,1,10,4-5,3-4,HSSA
Susan Mazer,50,0,0,0,0,50,3-4,3-4,HSSA
Susan Naughton,371,93,11,0,3,478,4-5,2-3,HSSA
Susan Stonich,88,112,33,3,6,242,1-2,3-4,HSSA
Susannah Scott,357,252,85,21,12,727,4-5,2-3,HSSA
Sven Spieker,407,283,93,28,45,856,3-4,3-4,HSSA
Swati Rana,1004,765,98,7,39,1913,3-4,3-4,HSSA
Sylvester Ogbechie,998,672,171,41,67,1949,2-3,3-4,HSSA
TM Handscomb,41,37,12,1,3,94,1-2,3-4,HSSA
Tae-Yeoun Keum,188,273,50,6,9,526,4-5,3-4,HSSA
Tagart Sobotka,235,172,43,13,18,481,4-5,1-2,HSSA
Talya Meyers,258,219,92,16,17,602,3-4,3-4,HSSA
Tammy Afifi,1823,1246,205,10,21,3305,4-5,2-3,HSSA
Tania Israel,1771,519,108,25,26,2449,3-4,2-3,HSSA
Tara Tober,3670,1798,368,69,130,6035,4-5,2-3,HSSA
Tara Yosso,678,780,246,40,57,1801,2-3,3-4,HSSA
Teofilo Gonzalez,33,30,17,3,2,85,2-3,4-5,HSSA
Terence Keel,250,170,83,19,16,538,4-5,3-4,HSSA
Teresa Figueroa,1664,1429,303,50,61,3507,2-3,2-3,HSSA
Teresa Robertson,345,297,208,91,131,1072,3-4,3-4,HSSA
Teresa Shewry,1260,422,24,6,28,1740,4-5,2-3,HSSA
Terrance Wooten,407,235,61,13,12,728,4-5,3-4,HSSA
Thomas Barrett,1568,439,171,29,57,2264,4-5,2-3,HSSA
Thomas Holden,750,1420,478,32,76,2756,4-5,3-4,HSSA
Thomas Hughes,357,1320,430,39,59,2205,4-5,3-4,HSSA
Thomas L. Turner,18,0,0,0,0,18,3-4,3-4,HSSA
Thomas Mazanec,807,378,91,24,36,1336,4-5,2-3,HSSA
Thomas Moody,709,168,31,1,14,923,4-5,1-2,HSSA
Thomas Tommy Sprague,1365,749,268,55,51,2488,4-5,2-3,HSSA
Thomas Weimbs,123,0,0,0,1,124,2-3,3-4,HSSA
Thuc-Quyen Nguyen,19,0,0,0,0,19,3-4,3-4,HSSA
Tim Butzer,134,473,108,3,16,734,4-5,2-3,HSSA
Tim Cooley,714,256,75,19,38,1102,3-4,2-3,HSSA
Timothy Daniels,198,311,117,13,28,667,4-5,3-4,HSSA
Timothy Gilmore,1434,866,123,16,76,2515,3-4,2-3,HSSA
Timothy Linehan,115,295,151,27,25,613,4-5,2-3,HSSA
Tod Kippin,1952,650,138,26,34,2800,3-4,3-4,HSSA
Todd Squires,754,498,136,13,11,1412,4-5,2-3,HSSA
Tom Carlson,501,473,188,40,68,1270,4-5,4-5,HSSA
Tom Costigan,552,32,4,2,12,602,4-5,1-2,HSSA
Tommy Dickey,59,0,0,0,1,60,4-5,1-2,HSSA
Tristan Bridges,624,480,54,8,57,1223,4-5,3-4,HSSA
Tsuyoshi Hasegawa,480,1166,656,80,86,2468,3-4,3-4,HSSA
Tug Goddard,76,100,53,2,22,253,1-2,3-4,HSSA
Tyler Branson,351,63,9,0,3,426,4-5,2-3,HSSA
Tyler Susko,27,2,0,0,1,30,2-3,2-3,HSSA
Tymoteusz Chajdas,324,128,61,12,10,535,3-4,2-3,HSSA
Ulrich Keller,244,287,63,10,17,621,3-4,2-3,HSSA
Valentina Padula,1656,1243,404,64,58,3425,4-5,2-3,HSSA
Valerie Huston,1745,1154,19,3,25,2946,4-5,4-5,HSSA
Vanessa Woods,4012,2718,1036,216,240,8222,3-4,3-4,HSSA
Veronica Fematt,41,117,57,14,13,242,4-5,2-3,HSSA
Vesna Wallace,866,524,108,21,38,1557,3-4,2-3,HSSA
Vickie Scott,2703,225,58,15,58,3059,3-4,2-3,HSSA
Vickie Vertiz,601,92,17,2,20,732,4-5,2-3,HSSA
Victor Bell,1763,9,2,0,3,1777,4-5,1-2,HSSA
Victor Rios,2859,1031,188,27,34,4139,4-5,1-2,HSSA
Vincent Rone,436,335,116,22,17,926,4-5,2-3,HSSA
Viola Miglio,1313,399,76,17,27,1832,4-5,2-3,HSSA
Volker Welter,1233,829,218,21,71,2372,3-4,3-4,HSSA
Voula Tsouna,809,910,168,11,57,1955,3-4,3-4,HSSA
Wade Roof,493,298,61,7,10,869,3-4,2-3,HSSA
Walid Afifi,1236,1759,443,66,60,3564,3-4,3-4,HSSA
Warren Wood,17,10,5,1,3,36,3-4,2-3,HSSA
Wendy Wiseman,278,202,53,7,59,599,2-3,4-5,HSSA
Weston McCool,118,179,80,24,22,423,3-4,3-4,HSSA
William Davies King,1047,878,177,28,92,2222,3-4,2-3,HSSA
William Elison,489,259,54,11,24,837,4-5,2-3,HSSA
William Robinson,3570,1677,690,137,325,6399,3-4,3-4,HSSA
William Smith,74,48,11,1,7,141,3-4,3-4,HSSA
William Thompson,512,247,64,7,29,859,4-5,2-3,HSSA
William Warner,424,519,125,7,18,1093,2-3,3-4,HSSA
Wolf Kittler,1706,1209,309,39,109,3372,2-3,2-3,HSSA
Wona Lee,1217,281,98,9,11,1616,4-5,2-3,HSSA
Xiao-Bin JI,232,272,67,12,16,599,4-5,2-3,HSSA
Xiaojian Zhao,1714,1309,568,85,105,3781,3-4,2-3,HSSA
Xiaolei Zhao,1714,1309,568,85,105,3781,3-4,4-5,HSSA
Xiaorong Li,1356,1189,347,64,90,3046,3-4,3-4,HSSA
Xiaowei Zheng,906,699,166,12,39,1822,4-5,3-4,HSSA
Xin Zhou,19,22,3,0,1,45,2-3,3-4,HSSA
Ya Zuo,349,137,38,9,14,547,4-5,2-3,HSSA
Yader Lanuza,1165,179,47,16,44,1451,4-5,1-2,HSSA
Yekaterina Kate Kharitonova,107,37,13,3,6,166,2-3,3-4,HSSA
Young Ji Kim,31,12,0,0,0,43,4-5,3-4,HSSA
Yueyuan Ma,73,47,10,2,6,138,1-2,4-5,HSSA
Zachary King,350,102,35,9,20,516,4-5,3-4,HSSA
Zachary Rentz,286,263,83,20,12,664,4-5,2-3,HSSA
Zakiya Luna,422,296,58,7,15,798,1-2,3-4,HSSA
Ziad Matni,846,1082,402,112,109,2551,4-5,3-4,HSSA
Zoe Liberman,1443,1350,546,162,141,3642,3-4,3-4,HSSA
jean beaman,220,204,59,13,16,512,2-3,2-3,HSSA
